#######################################
#    W       B                     S  #
#    W                B               #
#                B                    #
# P                                S  #
#                   B        W        #
#    W        B   B   B  B   W        #
#    W                       W    S   #
#######################################
<WAVES>
1 1
1 2
1 5
5 3
1 9
